30 30
* * * * * * , , , , , , , , , , , , , , , , , , . . . . . .
* * * * * . , , , , , , , , , , , , , , , , , , . . . . . *
* * . . . . , , , , , , , , , , , , , , , , , , . . . * * *
* . . . . . . . . . . . . . . . . . . . . . . . . . * * * *
. . . . . . . . . . . . . . . . . . . . . . . . . . . * * *
. . . . . . . . . * * . . . . . . . . . . * . . . . . . . *
. . . . . . . . . . * . . . . . . . . * * * * . . . . . . *
. . . . * . . . . . . . . . . . . . . . . * * * . . . . . .
. . . . * * . . . . . . . . . . . . . . . . * * . . . . . *
. . . * * * . . . . . . . * . . . . . . . . . . . . . . . *
. . * * * * . . . . . . * * * * . . . . . . . . . . . . * *
. . * * * * . . . . . * * * * * * . . . . . . . . . . * * *
. . . * * * * . . . * * * * * * * * . . . * * . . . . . * *
. . . * * * . . . . . * * . . . * . . . . . * . . . . . * *
. . . . * . . . . . . . . . . . . . . . . . . . . . . . . *
. . . . . . . . . . . . . . . . . . . . . . . . . . . . . .
. . . . . . . . . . . . . . . . . . . . . . . . . . . * . .
* . . . . . . * * . . . . . * * * . . . . . . . . . * * * .
* * . . . . * * . . . . . * * * * * . . . . . . . . * * * .
* * * . . . * . . . . . . . * * * * * . . . . . . * * * . .
* * . . . . . . . . . . . . . . * * * * . . . . . . * * . .
* * . . . . . . . . . * . . . . . . * * * . . . . . * . . .
* . . . . . . . . . * * * . . . . . . . . . . . . . . . . .
* . . . . . . . . . * * . . . . . . . . . . . . . . . . . .
. . . . * . . . . . . * . . . . . . . . . . . . . . . . . *
. . . * * * . . . . . . . . . . . . . . . . . . . . . . . *
. . * * * . . . . . . . . . . . . . . . . . . . . . . . * *
. . * * . . , , , , , , , , , , , , , , , , , , . . . . * *
. . . * . . , , , , , , , , , , , , , , , , , , . * * * * *
. . . . . . , , , , , , , , , , , , , , , , , , . . . . . .